{
	"world":
	{
		"background":"images/placeholder/ph_background.png",
		"tileSet":"images/placeholder/basetileset2.png",
		"frame_w":64,
		"frame_h":64,
		"frames_per_line":1,
		"tileMap":
		[
			[1,1,1,1,1,1,1,1,1,1,1,1,1,1,1,1,1,1,1,1],
			[1,0,0,0,0,0,0,0,0,0,0,0,0,0,0,0,0,0,0,1],
			[1,0,0,0,0,0,0,0,0,0,0,0,0,0,0,0,0,0,0,1],
			[1,0,0,2,2,2,2,2,0,0,0,0,0,0,0,0,0,0,0,1],
			[1,0,0,0,0,0,0,0,0,0,0,0,0,2,2,2,2,0,0,1],
			[1,0,0,0,0,0,0,0,0,0,0,0,0,0,0,0,0,0,0,1],
			[1,0,0,0,0,0,3,3,3,3,3,3,0,0,0,0,0,0,0,1],
			[1,0,0,0,0,0,0,0,0,0,0,0,0,0,0,0,0,0,0,1],
			[1,0,0,0,0,0,0,0,0,0,0,0,0,0,0,0,0,0,0,1],
			[1,0,4,4,4,4,0,0,0,0,0,0,0,0,4,4,4,4,0,1],
			[1,0,0,0,0,0,0,0,0,0,0,0,0,0,0,0,0,0,0,1],
			[1,1,1,1,1,1,1,1,1,1,1,1,1,1,1,1,1,1,1,1]
		]
	}
}